#BLR-ベラルーシ
NBL	= "countries/Eastern Europe.txt"	#ベラルーシ国民共和国

#BRA-ブラジル
CSB	= "countries/South America.txt"	#ブラジル連合国

#BRM-ビルマ
BCP	= "countries/Asia.txt"	#ビルマ共産党
MYP	= "countries/Asia.txt"	#ミャンマー共和国

#CHI-中華
CHP	= "countries/Asia.txt"	#中華合衆国

#FRA-フランス
FRP	= "countries/Western Europe.txt"	#フランス連合共和国
NFR	= "countries/Western Europe.txt"	#北フランス

#GER-ドイツ
ARO	= "countries/Western Europe.txt"	#ローゼンベルク反乱軍
CGR	= "countries/Western Europe.txt"	#ドイツ・コミューン
EDL	= "countries/Western Europe.txt"	#エーデルワイス海賊団
GRC	= "countries/Western Europe.txt"	#ドイツ市民軍
HGR	= "countries/Western Europe.txt"	#ゲーリング派ドイツ
HLH	= "countries/Western Europe.txt"	#ヒムラー派ドイツ
LTV	= "countries/Western Europe.txt"	#反ナチス派ドイツ
MBR	= "countries/Western Europe.txt"	#ボルマン派ドイツ
PBH	= "countries/Western Europe.txt"	#ボウラー反乱軍
RDA	= "countries/Western Europe.txt"	#ダレ反乱軍
SCH	= "countries/Western Europe.txt"	#シェップマン反乱軍
WLK	= "countries/Western Europe.txt"	#カイテル反乱軍

#INS-インドネシア
IDN	= "countries/Asia.txt"	#インドネシア連合共和国

#IRE-アイルランド
IRP	= "countries/Western Europe.txt"	#アイルランド国

#ITA-イタリア
IPF	= "countries/Western Europe.txt"	#イタリア人民解放戦線
ITP	= "countries/Western Europe.txt"	#イタリア連邦
RSI	= "countries/Western Europe.txt"	#イタリア社会共和国

#JAP-日本
JPN = "countries/Asia.txt" 	#日本国
JSF = "countries/Asia.txt" 	#日本社会主義戦線
PRJ = "countries/Asia.txt" 	#日本社会主義人民共和国

#MEX-メキシコ
MXP	= "countries/South America.txt"	#メキシコ国

#NOR-ノルウェー
FNO	= "countries/Western Europe.txt"	#ノルウェー解放戦線(ノルウェー王国)

#MAN-満州
DKJ	= "countries/Asia.txt"	#東北抗日聯軍
GRG	= "countries/Asia.txt"	#在家裡
JDN	= "countries/Asia.txt"	#ユダヤ人評議会
MRL	= "countries/Asia.txt"	#満鉄統治区域
NAJ	= "countries/Asia.txt"	#東北救国抗日聯軍
REH	= "countries/Asia.txt"	#熱河政府
RSS	= "countries/Asia.txt"	#紅卍字会
WBC	= "countries/Asia.txt"	#労働者・建設者評議会
WHA	= "countries/Asia.txt"	#白軍共和国
WHK	= "countries/Asia.txt"	#小白竜軍閥
WSS	= "countries/Asia.txt"	#543部隊
XGA	= "countries/Asia.txt"	#興安軍

#MON-モンゴル
MPR	= "countries/Asia.txt"	#モンゴル人民共和国

#RUS-ロシア
ACO	= "countries/Eastern Europe.txt"	#貴族評議会
AMC	= "countries/Eastern Europe.txt"	#大天使ミハイル国
BLO	= "countries/Eastern Europe.txt"	#ブラック・オーダー
FAR	= "countries/Eastern Europe.txt"	#全ロシア民族解放統一戦線
RBL	= "countries/Eastern Europe.txt"	#ロシアの空解放同盟
RLB	= "countries/Eastern Europe.txt"	#自由主義ロシア
RSE	= "countries/Eastern Europe.txt"	#ロシア帝国
RSP	= "countries/Eastern Europe.txt"	#ロシア連邦
TOA	= "countries/Eastern Europe.txt"	#大司教領

#SIA-シャム
THA	= "countries/Asia.txt"	#タイ共和国

#SPR-スペイン
SPA	= "countries/Western Europe.txt"	#スペイン共和国
SPC	= "countries/Western Europe.txt"	#スペイン企業評議会
SPF	= "countries/Western Europe.txt"	#フランス系スペイン共和国
SPX	= "countries/Western Europe.txt"	#スペイン亡命政権

#UKR-ウクライナ
UKP	= "countries/Eastern Europe.txt"	#ウクライナ国

#USA-アメリカ
ALF	= "countries/Western Europe.txt"	#アメリカ自由連盟
ANS	= "countries/Western Europe.txt"	#無政府州
BLS	= "countries/Western Europe.txt"	#ブラックステート
FSA	= "countries/Western Europe.txt"	#アメリカ連邦
LFF	= "countries/Western Europe.txt"	#左翼戦線
UTC	= "countries/Western Europe.txt"	#三社連合

#国家弁務官区
IBE	= "countries/Western Europe.txt"	#イベリア国家弁務官区
RKE	= "countries/Western Europe.txt"	#イングランド国家弁務官区
RKF	= "countries/Western Europe.txt"	#フランクライヒ国家弁務官区
RKN	= "countries/Western Europe.txt"	#ノルディック国家弁務官区
RKW	= "countries/Western Europe.txt"	#ヴェストリヒャ・アンザッツ国家弁務官区
RNB	= "countries/Eastern Europe.txt"	#ノルトバルカン国家弁務官区
RTR	= "countries/Middle East.txt"	#トルターン国家弁務官区
RWU	= "countries/Eastern Europe.txt"	#ヴェストウラル国家弁務官区
RZB	= "countries/Eastern Europe.txt"	#ズュートバルカン国家弁務官区
